1111111111111111111
111110P000000X11111
1111000000000001111
11100000110000P0111
1100001111110000011
1000000011C000X0001
10X0000011000000001
10C000001E000000C01
1000000000000X00001
100000000C000000001
1111111111111111111